4
4,2,1
false
0
2
1,5,2
1,7,2
##########
#...#B.M.#
#.#...##.#
#.###.#..#
#.PG#.#.##
##..#....#
#.#.###.##
#.....#..#
#####.#.E#
##########
Saved Game
